cannot that they're over from ours other so a at my yours where's whom you'll or haven't are was into too we've couldn't for there before yourselves they'd not with below in having do he'd each could off he doesn't him have weren't out about been hers these here down what's which me again of its ought should to during up she'll would you're and them when's being i'm it's she'd myself didn't they've wasn't an those how few the is ourselves she against herself aren't you'd where because through as we own why's hadn't how's let's between some had very be nor am that's himself i've it we'll themselves then all who itself he's both her who's same were hasn't most after i by you any you've such they'll while isn't once don't this above i'd theirs has they our under your can't more doing when what if on i'll mustn't shouldn't there's no but we'd wouldn't his only their we're shan't she's does yourself further until why than here's did won't he'll
а большой 	бы
быть 	в 	весь
вот 	все 	всё 	всей	всем	всеми	всех	всю
вы 	говорить 	год
да даже	для 	до
еще ещё	же 	за знать
и 	из из-за	к
как 	который ли мочь
мы 	на 	наш
не 	него 	нее	неё
нет 	них 	но
о 	один 	она
они 	оно 	оный
от 	ото 	по
с 	свой 	себя
сказать 	та 	такой
только 	тот 	ты
у уж уже	что 	это
этот 	я
любой лет
0 1 2 3 4 5 6 7 8 9
ноль нуль один два три четыре пять шесть семь восемь девять десять
двадцать тридцать сорок пятьдесят шетьдесят семьдесят восемьдесят девяносто
сто двести триста четыреста пятьсот
еще	него
ж	со
без	же	ней	совсем
более	жизнь	нельзя	так
больше	за	нет	такой
будет	зачем	ни	там
будто	здесь	нибудь	тебя
бы	и	никогда	тем
был	из	ним	теперь
была	них	то
были	или	ничего	тогда
было	им	но	того
быть	иногда	ну	тоже
в	их	о	только
вам	к	об	том
вас	кажется	один	тот
вдруг	как	он	три
ведь	какая	она	тут
во	какой	они	ты
вот	когда	опять	у
впрочем	конечно	от	уж
все	которого	перед	уже
всегда	которые	по	хорошо
всего	кто	под	хоть
всех	куда	после	чего
всю	ли	потом	человек
вы	лучше	потому	чем
г	между	почти	через
где	меня	при	что
говорил	мне	про	чтоб
да	много	раз	чтобы
даже	может	разве	чуть
два	можно	с	эти	этим
для	мой	сам	этого
до	моя	свое	этой
другой	мы	свою	этом
его	на	себе	этот
ее	над	себя	эту
ей	надо	сегодня	я
ему	наконец	сейчас	
если	нас	сказал	
есть	не	сказала
чаще